16, 16, 16, 16, 16, 16, 16, 16, 16, 16, 16, 16, 16, 16, 16, 16, 16, 16, 16, 16, 16, 16, 16, 16, 16, 16, 16, 16, 16, 16, 16, 16, 16, 16, 16, 16, 16, 16, 16, 16, 16, 16, 16, 16, 16, 16, 16, 16, 16, 16, 16, 16, 16, 16, 16, 16
16, 5, 3, 3, 3, 3, 7, 3, 3, 3, 3, 3, 6, 16, 16, 5, 3, 3, 3, 3, 3, 7, 3, 3, 3, 3, 7, 3, 3, 7, 3, 3, 3, 3, 7, 3, 3, 3, 3, 3, 6, 16, 16, 5, 3, 3, 3, 3, 3, 7, 3, 3, 3, 3, 6, 16
16, 12, 15, 15, 15, 15, 15, 15, 15, 15, 15, 15, 15, 15, 15, 15, 15, 15, 15, 15, 15, 15, 15, 15, 15, 15, 15, 15, 15, 15, 15, 15, 15, 15, 15, 15, 15, 15, 15, 15, 15, 15, 15, 15, 15, 15, 15, 15, 15, 15, 15, 15, 15, 15, 12, 16
16, 12, 15, 0, 0, 16, 12, 16, 0, 0, 0, 16, 12, 16, 16, 12, 16, 0, 0, 0, 16, 12, 16, 0, 0, 16, 12, 16, 16, 12, 16, 0, 0, 16, 12, 16, 0, 0, 0, 15, 15, 15, 15, 15, 15, 15, 15, 15, 15, 15, 15, 15, 15, 15, 12, 16
16, 12, 15, 16, 16, 16, 12, 16, 16, 16, 16, 16, 12, 16, 16, 12, 16, 16, 16, 16, 16, 12, 16, 16, 16, 16, 12, 16, 16, 12, 16, 16, 16, 16, 12, 16, 16, 16, 16, 16, 12, 16, 16, 12, 16, 16, 16, 16, 16, 12, 16, 16, 15, 15, 12, 16
16, 13, 15, 3, 3, 3, 15, 3, 3, 7, 3, 3, 11, 3, 3, 11, 3, 3, 7, 3, 3, 15, 3, 3, 3, 3, 14, 16, 16, 13, 3, 3, 3, 3, 15, 3, 3, 7, 3, 3, 11, 3, 3, 11, 3, 3, 7, 3, 3, 15, 3, 3, 15, 15, 14, 16
16, 12, 15, 16, 16, 16, 12, 16, 16, 12, 16, 16, 16, 16, 16, 16, 16, 16, 12, 16, 16, 12, 16, 16, 16, 16, 12, 16, 16, 12, 16, 16, 16, 16, 12, 16, 16, 12, 16, 16, 16, 16, 16, 16, 16, 16, 12, 16, 16, 12, 16, 16, 15, 15, 12, 16
16, 12, 15, 16, 16, 16, 12, 16, 16, 12, 16, 16, 16, 16, 16, 16, 16, 16, 12, 16, 16, 12, 16, 16, 16, 16, 12, 16, 16, 12, 16, 16, 16, 16, 12, 16, 16, 12, 16, 16, 16, 16, 16, 16, 16, 16, 12, 16, 16, 12, 16, 16, 15, 15, 12, 16
16, 9, 15, 3, 3, 3, 14, 16, 16, 9, 3, 3, 6, 16, 16, 5, 3, 3, 10, 16, 16, 13, 3, 3, 3, 3, 11, 3, 3, 11, 3, 3, 3, 3, 14, 16, 16, 9, 3, 3, 6, 16, 16, 5, 3, 3, 10, 16, 16, 13, 3, 3, 15, 15, 10, 16
16, 16, 15, 16, 16, 16, 12, 16, 16, 16, 16, 16, 12, 16, 16, 12, 16, 16, 16, 16, 16, 12, 16, 16, 16, 16, 16, 16, 16, 16, 16, 16, 16, 16, 12, 16, 16, 16, 16, 16, 12, 16, 16, 12, 16, 16, 16, 16, 16, 12, 16, 16, 15, 15, 16, 16
16, 16, 15, 16, 0, 16, 12, 16, 16, 16, 16, 16, 12, 16, 16, 12, 16, 16, 16, 16, 16, 12, 16, 16, 16, 16, 16, 16, 16, 16, 16, 16, 16, 16, 12, 16, 16, 16, 16, 16, 12, 16, 16, 12, 16, 16, 16, 16, 16, 12, 16, 16, 15, 15, 0, 16
16, 16, 15, 0, 0, 16, 12, 16, 16, 5, 3, 3, 11, 3, 3, 11, 3, 3, 6, 16, 16, 13, 3, 3, 3, 3, 3, 3, 3, 3, 3, 3, 3, 3, 14, 16, 16, 5, 3, 3, 11, 3, 3, 11, 3, 3, 6, 16, 16, 12, 16, 16, 15, 15, 0, 16
16, 16, 15, 0, 0, 16, 12, 16, 16, 12, 16, 16, 16, 16, 16, 16, 16, 16, 12, 16, 16, 12, 16, 16, 16, 16, 16, 16, 16, 16, 16, 16, 16, 16, 12, 16, 16, 12, 16, 16, 16, 16, 16, 16, 16, 16, 12, 16, 16, 12, 16, 16, 15, 15, 0, 16
16, 16, 15, 0, 0, 16, 12, 16, 16, 12, 16, 0, 0, 0, 0, 0, 0, 16, 12, 16, 16, 12, 16, 0, 16, 16, 16, 16, 16, 16, 16, 16, 0, 16, 12, 16, 16, 12, 16, 0, 0, 0, 0, 0, 0, 16, 12, 16, 16, 12, 16, 16, 15, 15, 0, 16
16, 16, 15, 0, 0, 16, 13, 3, 3, 14, 16, 0, 0, 0, 0, 0, 0, 16, 13, 3, 3, 14, 16, 0, 0, 0, 0, 16, 16, 0, 0, 0, 0, 16, 13, 3, 3, 14, 16, 16, 16, 16, 16, 0, 0, 16, 13, 3, 3, 14, 16, 16, 15, 15, 0, 16
16, 16, 15, 0, 0, 16, 12, 15, 15, 12, 16, 0, 0, 16, 16, 0, 0, 16, 12, 16, 16, 12, 16, 0, 0, 0, 0, 16, 16, 0, 0, 0, 0, 16, 12, 16, 16, 12, 16, 0, 0, 0, 0, 0, 0, 16, 12, 16, 16, 12, 16, 16, 15, 15, 0, 16
16, 16, 15, 0, 0, 16, 12, 15, 15, 12, 16, 16, 16, 16, 16, 16, 16, 16, 12, 16, 16, 12, 16, 16, 16, 16, 16, 16, 16, 16, 16, 16, 16, 16, 12, 16, 16, 12, 16, 16, 16, 16, 16, 16, 16, 16, 12, 16, 16, 12, 16, 16, 15, 15, 0, 16
16, 16, 15, 0, 0, 16, 12, 15, 15, 13, 3, 3, 3, 3, 3, 3, 3, 3, 14, 16, 16, 13, 3, 3, 3, 3, 3, 3, 3, 3, 3, 3, 3, 3, 14, 16, 16, 13, 3, 3, 3, 3, 3, 3, 3, 3, 14, 16, 16, 12, 16, 16, 15, 15, 0, 16
16, 16, 15, 0, 0, 16, 12, 15, 15, 12, 16, 16, 16, 16, 16, 16, 16, 16, 12, 16, 16, 12, 16, 16, 16, 16, 16, 16, 16, 16, 16, 16, 16, 16, 12, 16, 16, 12, 16, 16, 16, 16, 16, 16, 16, 16, 12, 16, 16, 12, 16, 16, 15, 15, 0, 16
16, 16, 15, 16, 16, 16, 12, 15, 15, 12, 16, 16, 16, 16, 16, 16, 16, 16, 12, 16, 16, 12, 16, 16, 16, 16, 16, 16, 16, 16, 16, 16, 16, 16, 12, 16, 16, 12, 16, 16, 16, 16, 16, 16, 16, 16, 12, 16, 16, 12, 16, 16, 15, 15, 16, 16
16, 5, 15, 3, 3, 3, 15, 3, 3, 11, 3, 3, 6, 16, 16, 5, 3, 3, 11, 3, 3, 15, 3, 3, 3, 3, 7, 3, 3, 7, 3, 3, 3, 3, 15, 3, 3, 11, 3, 3, 6, 16, 16, 5, 3, 3, 11, 3, 3, 15, 3, 3, 15, 15, 6, 16
16, 12, 15, 16, 16, 16, 12, 16, 16, 16, 16, 16, 12, 16, 16, 12, 16, 16, 16, 16, 16, 12, 16, 16, 16, 16, 12, 16, 16, 12, 16, 16, 16, 16, 12, 16, 16, 16, 16, 16, 12, 16, 16, 12, 16, 16, 16, 16, 16, 12, 16, 16, 15, 15, 12, 16
16, 12, 15, 16, 16, 16, 12, 16, 16, 16, 16, 16, 12, 16, 16, 12, 16, 16, 16, 16, 16, 12, 16, 16, 16, 16, 12, 16, 16, 12, 16, 16, 16, 16, 12, 16, 16, 16, 16, 16, 12, 16, 16, 12, 16, 16, 16, 16, 16, 12, 16, 16, 15, 15, 12, 16
16, 9, 15, 6, 16, 16, 13, 3, 3, 7, 3, 3, 11, 3, 3, 11, 3, 3, 7, 3, 3, 14, 16, 16, 5, 3, 10, 16, 16, 9, 3, 6, 16, 16, 13, 3, 3, 7, 3, 3, 11, 3, 3, 11, 3, 3, 7, 3, 3, 14, 16, 16, 15, 15, 10, 16
16, 16, 15, 12, 16, 16, 12, 16, 16, 12, 16, 16, 16, 16, 16, 16, 16, 16, 12, 16, 16, 12, 16, 16, 12, 16, 16, 16, 16, 16, 16, 12, 16, 16, 12, 16, 16, 12, 16, 16, 16, 16, 16, 16, 16, 16, 12, 16, 16, 12, 16, 16, 15, 15, 16, 16
16, 16, 15, 12, 16, 16, 12, 16, 16, 12, 16, 16, 16, 16, 16, 16, 16, 16, 12, 16, 16, 12, 16, 16, 12, 16, 16, 16, 16, 16, 16, 12, 16, 16, 12, 16, 16, 12, 16, 16, 16, 16, 16, 16, 16, 16, 12, 16, 16, 12, 16, 16, 15, 15, 16, 16
16, 5, 15, 11, 3, 3, 10, 16, 16, 9, 3, 3, 6, 16, 16, 5, 3, 3, 10, 16, 16, 9, 3, 3, 11, 3, 6, 16, 16, 5, 3, 11, 3, 3, 10, 16, 16, 9, 3, 3, 6, 16, 16, 5, 3, 3, 10, 16, 16, 9, 3, 3, 15, 15, 6, 16
16, 12, 15, 15, 15, 15, 15, 15, 15, 15, 15, 15, 15, 15, 15, 15, 15, 15, 15, 15, 15, 15, 15, 15, 15, 15, 15, 15, 15, 15, 15, 15, 15, 15, 15, 15, 15, 15, 15, 15, 15, 15, 15, 15, 15, 15, 15, 15, 15, 15, 15, 15, 15, 15, 12, 16
16, 12, 15, 15, 15, 15, 15, 15, 15, 15, 15, 15, 15, 15, 15, 15, 15, 15, 15, 15, 15, 15, 15, 15, 15, 15, 15, 15, 15, 15, 15, 15, 15, 15, 15, 15, 15, 15, 15, 15, 15, 15, 15, 15, 15, 15, 15, 15, 15, 15, 15, 15, 15, 15, 12, 16
16, 9, 3, 3, 3, 3, 3, 3, 3, 3, 3, 3, 11, 3, 3, 11, 3, 3, 3, 3, 3, 3, 3, 3, 3, 3, 11, 3, 3, 11, 3, 3, 3, 3, 3, 3, 3, 3, 3, 3, 11, 3, 3, 11, 3, 3, 3, 3, 3, 3, 3, 3, 3, 3, 10, 16
16, 16, 16, 16, 16, 16, 16, 16, 16, 16, 16, 16, 16, 16, 16, 16, 16, 16, 16, 16, 16, 16, 16, 16, 16, 16, 16, 16, 16, 16, 16, 16, 16, 16, 16, 16, 16, 16, 16, 16, 16, 16, 16, 16, 16, 16, 16, 16, 16, 16, 16, 16, 16, 16, 16, 16
