16, 16, 16, 16, 16, 16, 16, 16, 16, 16, 16, 16, 16, 16, 16, 16, 16, 16, 16, 16, 16, 16, 16, 16, 16, 16, 16, 16, 16, 16, 16, 16, 16, 16, 16, 16, 16, 16, 16, 16, 16, 16, 16, 16, 16, 16, 16, 16, 16, 16, 16, 16, 16, 16, 16, 16,16, 16, 16, 16, 16, 16, 16, 16, 16, 16, 16, 16, 16, 16, 16, 16, 16, 16, 16, 16, 16, 16, 16, 16, 16, 16, 16, 16, 16, 16, 16, 16, 16, 16, 16, 16, 16, 16, 16, 16, 16, 16, 16, 16, 16, 16, 16, 16, 16, 16, 16, 16, 16, 16, 16, 16
16,  5,  3,  3,  3,  3,  7,  3,  3,  3,  3,  3,  6, 16, 16,  5,  3,  3,  3,  3,  3,  7,  3,  3,  3,  3,  7,  3,  3,  7,  3,  3,  3,  3,  7,  3,  3,  3,  3,  3,  6, 16, 16,  5,  3,  3,  3,  3,  3,  7,  3,  3,  3,  3,  6, 16,16,  5,  3,  3,  3,  3,  7,  3,  3,  3,  3,  3,  6, 16, 16,  5,  3,  3,  3,  3,  3,  7,  3,  3,  3,  3,  7,  3,  3,  7,  3,  3,  3,  3,  7,  3,  3,  3,  3,  3,  6, 16, 16,  5,  3,  3,  3,  3,  3,  7,  3,  3,  3,  3,  6, 16
16, 12, 16, 16, 16, 16, 12, 16, 16, 16, 16, 16, 12, 16, 16, 12, 16, 16, 16, 16, 16, 12, 16, 16, 16, 16, 12, 16, 16, 12, 16, 16, 16, 16, 12, 16, 16, 16, 16, 16, 12, 16, 16, 12, 16, 16, 16, 16, 16, 12, 16, 16, 16, 16, 12, 16,16, 12, 16, 16, 16, 16, 12, 16, 16, 16, 16, 16, 12, 16, 16, 12, 16, 16, 16, 16, 16, 12, 16, 16, 16, 16, 12, 16, 16, 12, 16, 16, 16, 16, 12, 16, 16, 16, 16, 16, 12, 16, 16, 12, 16, 16, 16, 16, 16, 12, 16, 16, 16, 16, 12, 16
16, 12, 16,  0,  0, 16, 12, 16,  0,  0,  0, 16, 12, 16, 16, 12, 16,  0,  0,  0, 16, 12, 16,  0,  0, 16, 12, 16, 16, 12, 16,  0,  0, 16, 12, 16,  0,  0,  0, 16, 12, 16, 16, 12, 16,  0,  0,  0, 16, 12, 16,  0,  0, 16, 12, 16,16, 12, 16,  0,  0, 16, 12, 16,  0,  0,  0, 16, 12, 16, 16, 12, 16,  0,  0,  0, 16, 12, 16,  0,  0, 16, 12, 16, 16, 12, 16,  0,  0, 16, 12, 16,  0,  0,  0, 16, 12, 16, 16, 12, 16,  0,  0,  0, 16, 12, 16,  0,  0, 16, 12, 16
16, 12, 16, 16, 16, 16, 12, 16, 16, 16, 16, 16, 12, 16, 16, 12, 16, 16, 16, 16, 16, 12, 16, 16, 16, 16, 12, 16, 16, 12, 16, 16, 16, 16, 12, 16, 16, 16, 16, 16, 12, 16, 16, 12, 16, 16, 16, 16, 16, 12, 16, 16, 16, 16, 12, 16,16, 12, 16, 16, 16, 16, 12, 16, 16, 16, 16, 16, 12, 16, 16, 12, 16, 16, 16, 16, 16, 12, 16, 16, 16, 16, 12, 16, 16, 12, 16, 16, 16, 16, 12, 16, 16, 16, 16, 16, 12, 16, 16, 12, 16, 16, 16, 16, 16, 12, 16, 16, 16, 16, 12, 16
16, 13,  3,  3,  3,  3, 15,  3,  3,  7,  3,  3, 11,  3,  3, 11,  3,  3,  7,  3,  3, 15,  3,  3,  3,  3, 14, 16, 16, 13,  3,  3,  3,  3, 15,  3,  3,  7,  3,  3, 11,  3,  3, 11,  3,  3,  7,  3,  3, 15,  3,  3,  3,  3, 14, 16,16, 13,  3,  3,  3,  3, 15,  3,  3,  7,  3,  3, 11,  3,  3, 11,  3,  3,  7,  3,  3, 15,  3,  3,  3,  3, 14, 16, 16, 13,  3,  3,  3,  3, 15,  3,  3,  7,  3,  3, 11,  3,  3, 11,  3,  3,  7,  3,  3, 15,  3,  3,  3,  3, 14, 16
16, 12, 16, 16, 16, 16, 12, 16, 16, 12, 16, 16, 16, 16, 16, 16, 16, 16, 12, 16, 16, 12, 16, 16, 16, 16, 12, 16, 16, 12, 16, 16, 16, 16, 12, 16, 16, 12, 16, 16, 16, 16, 16, 16, 16, 16, 12, 16, 16, 12, 16, 16, 16, 16, 12, 16,16, 12, 16, 16, 16, 16, 12, 16, 16, 12, 16, 16, 16, 16, 16, 16, 16, 16, 12, 16, 16, 12, 16, 16, 16, 16, 12, 16, 16, 12, 16, 16, 16, 16, 12, 16, 16, 12, 16, 16, 16, 16, 16, 16, 16, 16, 12, 16, 16, 12, 16, 16, 16, 16, 12, 16
16, 12, 16, 16, 16, 16, 12, 16, 16, 12, 16, 16, 16, 16, 16, 16, 16, 16, 12, 16, 16, 12, 16, 16, 16, 16, 12, 16, 16, 12, 16, 16, 16, 16, 12, 16, 16, 12, 16, 16, 16, 16, 16, 16, 16, 16, 12, 16, 16, 12, 16, 16, 16, 16, 12, 16,16, 12, 16, 16, 16, 16, 12, 16, 16, 12, 16, 16, 16, 16, 16, 16, 16, 16, 12, 16, 16, 12, 16, 16, 16, 16, 12, 16, 16, 12, 16, 16, 16, 16, 12, 16, 16, 12, 16, 16, 16, 16, 16, 16, 16, 16, 12, 16, 16, 12, 16, 16, 16, 16, 12, 16
16,  9,  3,  3,  3,  3, 14, 16, 16,  9,  3,  3,  6, 16, 16,  5,  3,  3, 10, 16, 16, 13,  3,  3,  3,  3, 11,  3,  3, 11,  3,  3,  3,  3, 14, 16, 16,  9,  3,  3,  6, 16, 16,  5,  3,  3, 10, 16, 16, 13,  3,  3,  3,  3, 10, 16,16,  9,  3,  3,  3,  3, 14, 16, 16,  9,  3,  3,  6, 16, 16,  5,  3,  3, 10, 16, 16, 13,  3,  3,  3,  3, 11,  3,  3, 11,  3,  3,  3,  3, 14, 16, 16,  9,  3,  3,  6, 16, 16,  5,  3,  3, 10, 16, 16, 13,  3,  3,  3,  3, 10, 16
16, 16, 16, 16, 16, 16, 12, 16, 16, 16, 16, 16, 12, 16, 16, 12, 16, 16, 16, 16, 16, 12, 16, 16, 16, 16, 16, 16, 16, 16, 16, 16, 16, 16, 12, 16, 16, 16, 16, 16, 12, 16, 16, 12, 16, 16, 16, 16, 16, 12, 16, 16, 16, 16, 16, 16,16, 16, 16, 16, 16, 16, 12, 16, 16, 16, 16, 16, 12, 16, 16, 12, 16, 16, 16, 16, 16, 12, 16, 16, 16, 16, 16, 16, 16, 16, 16, 16, 16, 16, 12, 16, 16, 16, 16, 16, 12, 16, 16, 12, 16, 16, 16, 16, 16, 12, 16, 16, 16, 16, 16, 16
16, 16, 16, 16,  0, 16, 12, 16, 16, 16, 16, 16, 12, 16, 16, 12, 16, 16, 16, 16, 16, 12, 16, 16, 16, 16, 16, 16, 16, 16, 16, 16, 16, 16, 12, 16, 16, 16, 16, 16, 12, 16, 16, 12, 16, 16, 16, 16, 16, 12, 16, 16, 16, 16,  0, 16,16, 16, 16, 16,  0, 16, 12, 16, 16, 16, 16, 16, 12, 16, 16, 12, 16, 16, 16, 16, 16, 12, 16, 16, 16, 16, 16, 16, 16, 16, 16, 16, 16, 16, 12, 16, 16, 16, 16, 16, 12, 16, 16, 12, 16, 16, 16, 16, 16, 12, 16, 16, 16, 16,  0, 16
16, 16,  0,  0,  0, 16, 12, 16, 16,  5,  3,  3, 11,  3,  3, 11,  3,  3,  6, 16, 16, 13,  3,  3,  3,  3,  3,  3,  3,  3,  3,  3,  3,  3, 14, 16, 16,  5,  3,  3, 11,  3,  3, 11,  3,  3,  6, 16, 16, 12, 16, 16,  0,  0,  0, 16,16, 16,  0,  0,  0, 16, 12, 16, 16,  5,  3,  3, 11,  3,  3, 11,  3,  3,  6, 16, 16, 13,  3,  3,  3,  3,  3,  3,  3,  3,  3,  3,  3,  3, 14, 16, 16,  5,  3,  3, 11,  3,  3, 11,  3,  3,  6, 16, 16, 12, 16, 16,  0,  0,  0, 16
16, 16,  0,  0,  0, 16, 12, 16, 16, 12, 16, 16, 16, 16, 16, 16, 16, 16, 12, 16, 16, 12, 16, 16, 16, 16, 16, 16, 16, 16, 16, 16, 16, 16, 12, 16, 16, 12, 16, 16, 16, 16, 16, 16, 16, 16, 12, 16, 16, 12, 16, 16,  0,  0,  0, 16,16, 16,  0,  0,  0, 16, 12, 16, 16, 12, 16, 16, 16, 16, 16, 16, 16, 16, 12, 16, 16, 12, 16, 16, 16, 16, 16, 16, 16, 16, 16, 16, 16, 16, 12, 16, 16, 12, 16, 16, 16, 16, 16, 16, 16, 16, 12, 16, 16, 12, 16, 16,  0,  0,  0, 16
16, 16,  0,  0,  0, 16, 12, 16, 16, 12, 16,  0,  0,  0,  0,  0,  0, 16, 12, 16, 16, 12, 16,  0, 16, 16, 16, 16, 16, 16, 16, 16,  0, 16, 12, 16, 16, 12, 16,  0,  0,  0,  0,  0,  0, 16, 12, 16, 16, 12, 16, 16,  0,  0,  0, 16,16, 16,  0,  0,  0, 16, 12, 16, 16, 12, 16,  0,  0,  0,  0,  0,  0, 16, 12, 16, 16, 12, 16,  0, 16, 16, 16, 16, 16, 16, 16, 16,  0, 16, 12, 16, 16, 12, 16,  0,  0,  0,  0,  0,  0, 16, 12, 16, 16, 12, 16, 16,  0,  0,  0, 16
16, 16, 16,  0,  0, 16, 13,  3,  3, 14, 16,  0,  0,  0,  0,  0,  0, 16, 13,  3,  3, 14, 16,  0,  0,  0,  0, 16, 16,  0,  0,  0,  0, 16, 13,  3,  3, 14, 16, 16, 16, 16, 16,  0,  0, 16, 13,  3,  3, 14, 16, 16,  0,  0,  0, 16,16, 16, 16,  0,  0, 16, 13,  3,  3, 14, 16,  0,  0,  0,  0,  0,  0, 16, 13,  3,  3, 14, 16,  0,  0,  0,  0, 16, 16,  0,  0,  0,  0, 16, 13,  3,  3, 14, 16, 16, 16, 16, 16,  0,  0, 16, 13,  3,  3, 14, 16, 16,  0,  0,  0, 16
16, 16,  0,  0,  0, 16, 12, 16, 16, 12, 16,  0,  0, 16, 16,  0,  0, 16, 12, 16, 16, 12, 16,  0,  0,  0,  0, 16, 16,  0,  0,  0,  0, 16, 12, 16, 16, 12, 16,  0,  0,  0,  0,  0,  0, 16, 12, 16, 16, 12, 16, 16,  0,  0,  0, 16,16, 16,  0,  0,  0, 16, 12, 16, 16, 12, 16,  0,  0, 16, 16,  0,  0, 16, 12, 16, 16, 12, 16,  0,  0,  0,  0, 16, 16,  0,  0,  0,  0, 16, 12, 16, 16, 12, 16,  0,  0,  0,  0,  0,  0, 16, 12, 16, 16, 12, 16, 16,  0,  0,  0, 16
16, 16,  0,  0,  0, 16, 12, 16, 16, 12, 16, 16, 16, 16, 16, 16, 16, 16, 12, 16, 16, 12, 16, 16, 16, 16, 16, 16, 16, 16, 16, 16, 16, 16, 12, 16, 16, 12, 16, 16, 16, 16, 16, 16, 16, 16, 12, 16, 16, 12, 16, 16,  0,  0,  0, 16,16, 16,  0,  0,  0, 16, 12, 16, 16, 12, 16, 16, 16, 16, 16, 16, 16, 16, 12, 16, 16, 12, 16, 16, 16, 16, 16, 16, 16, 16, 16, 16, 16, 16, 12, 16, 16, 12, 16, 16, 16, 16, 16, 16, 16, 16, 12, 16, 16, 12, 16, 16,  0,  0,  0, 16
16, 16,  0,  0,  0, 16, 12, 16, 16, 13,  3,  3,  3,  3,  3,  3,  3,  3, 14, 16, 16, 13,  3,  3,  3,  3,  3,  3,  3,  3,  3,  3,  3,  3, 14, 16, 16, 13,  3,  3,  3,  3,  3,  3,  3,  3, 14, 16, 16, 12, 16, 16,  0,  0,  0, 16,16, 16,  0,  0,  0, 16, 12, 16, 16, 13,  3,  3,  3,  3,  3,  3,  3,  3, 14, 16, 16, 13,  3,  3,  3,  3,  3,  3,  3,  3,  3,  3,  3,  3, 14, 16, 16, 13,  3,  3,  3,  3,  3,  3,  3,  3, 14, 16, 16, 12, 16, 16,  0,  0,  0, 16
16, 16,  0,  0,  0, 16, 12, 16, 16, 12, 16, 16, 16, 16, 16, 16, 16, 16, 12, 16, 16, 12, 16, 16, 16, 16, 16, 16, 16, 16, 16, 16, 16, 16, 12, 16, 16, 12, 16, 16, 16, 16, 16, 16, 16, 16, 12, 16, 16, 12, 16, 16, 16, 16,  0, 16,16, 16,  0,  0,  0, 16, 12, 16, 16, 12, 16, 16, 16, 16, 16, 16, 16, 16, 12, 16, 16, 12, 16, 16, 16, 16, 16, 16, 16, 16, 16, 16, 16, 16, 12, 16, 16, 12, 16, 16, 16, 16, 16, 16, 16, 16, 12, 16, 16, 12, 16, 16, 16, 16,  0, 16
16, 16, 16, 16, 16, 16, 12, 16, 16, 12, 16, 16, 16, 16, 16, 16, 16, 16, 12, 16, 16, 12, 16, 16, 16, 16, 16, 16, 16, 16, 16, 16, 16, 16, 12, 16, 16, 12, 16, 16, 16, 16, 16, 16, 16, 16, 12, 16, 16, 12, 16, 16, 16, 16, 16, 16,16, 16, 16, 16, 16, 16, 12, 16, 16, 12, 16, 16, 16, 16, 16, 16, 16, 16, 12, 16, 16, 12, 16, 16, 16, 16, 16, 16, 16, 16, 16, 16, 16, 16, 12, 16, 16, 12, 16, 16, 16, 16, 16, 16, 16, 16, 12, 16, 16, 12, 16, 16, 16, 16, 16, 16
16,  5,  3,  3,  3,  3, 15,  3,  3, 11,  3,  3,  6, 16, 16,  5,  3,  3, 11,  3,  3, 15,  3,  3,  3,  3,  7,  3,  3,  7,  3,  3,  3,  3, 15,  3,  3, 11,  3,  3,  6, 16, 16,  5,  3,  3, 11,  3,  3, 15,  3,  3,  3,  3,  6, 16,16,  5,  3,  3,  3,  3, 15,  3,  3, 11,  3,  3,  6, 16, 16,  5,  3,  3, 11,  3,  3, 15,  3,  3,  3,  3,  7,  3,  3,  7,  3,  3,  3,  3, 15,  3,  3, 11,  3,  3,  6, 16, 16,  5,  3,  3, 11,  3,  3, 15,  3,  3,  3,  3,  6, 16
16, 12, 16, 16, 16, 16, 12, 16, 16, 16, 16, 16, 12, 16, 16, 12, 16, 16, 16, 16, 16, 12, 16, 16, 16, 16, 12, 16, 16, 12, 16, 16, 16, 16, 12, 16, 16, 16, 16, 16, 12, 16, 16, 12, 16, 16, 16, 16, 16, 12, 16, 16, 16, 16, 12, 16,16, 12, 16, 16, 16, 16, 12, 16, 16, 16, 16, 16, 12, 16, 16, 12, 16, 16, 16, 16, 16, 12, 16, 16, 16, 16, 12, 16, 16, 12, 16, 16, 16, 16, 12, 16, 16, 16, 16, 16, 12, 16, 16, 12, 16, 16, 16, 16, 16, 12, 16, 16, 16, 16, 12, 16
16, 12, 16, 16, 16, 16, 12, 16, 16, 16, 16, 16, 12, 16, 16, 12, 16, 16, 16, 16, 16, 12, 16, 16, 16, 16, 12, 16, 16, 12, 16, 16, 16, 16, 12, 16, 16, 16, 16, 16, 12, 16, 16, 12, 16, 16, 16, 16, 16, 12, 16, 16, 16, 16, 12, 16,16, 12, 16, 16, 16, 16, 12, 16, 16, 16, 16, 16, 12, 16, 16, 12, 16, 16, 16, 16, 16, 12, 16, 16, 16, 16, 12, 16, 16, 12, 16, 16, 16, 16, 12, 16, 16, 16, 16, 16, 12, 16, 16, 12, 16, 16, 16, 16, 16, 12, 16, 16, 16, 16, 12, 16
16,  9,  3,  6, 16, 16, 13,  3,  3,  7,  3,  3, 11,  3,  3, 11,  3,  3,  7,  3,  3, 14, 16, 16,  5,  3, 10, 16, 16,  9,  3,  6, 16, 16, 13,  3,  3,  7,  3,  3, 11,  3,  3, 11,  3,  3,  7,  3,  3, 14, 16, 16,  5,  3, 10, 16,16,  9,  3,  6, 16, 16, 13,  3,  3,  7,  3,  3, 11,  3,  3, 11,  3,  3,  7,  3,  3, 14, 16, 16,  5,  3, 10, 16, 16,  9,  3,  6, 16, 16, 13,  3,  3,  7,  3,  3, 11,  3,  3, 11,  3,  3,  7,  3,  3, 14, 16, 16,  5,  3, 10, 16
16, 16, 16, 12, 16, 16, 12, 16, 16, 12, 16, 16, 16, 16, 16, 16, 16, 16, 12, 16, 16, 12, 16, 16, 12, 16, 16, 16, 16, 16, 16, 12, 16, 16, 12, 16, 16, 12, 16, 16, 16, 16, 16, 16, 16, 16, 12, 16, 16, 12, 16, 16, 12, 16, 16, 16,16, 16, 16, 12, 16, 16, 12, 16, 16, 12, 16, 16, 16, 16, 16, 16, 16, 16, 12, 16, 16, 12, 16, 16, 12, 16, 16, 16, 16, 16, 16, 12, 16, 16, 12, 16, 16, 12, 16, 16, 16, 16, 16, 16, 16, 16, 12, 16, 16, 12, 16, 16, 12, 16, 16, 16
16, 16, 16, 12, 16, 16, 12, 16, 16, 12, 16, 16, 16, 16, 16, 16, 16, 16, 12, 16, 16, 12, 16, 16, 12, 16, 16, 16, 16, 16, 16, 12, 16, 16, 12, 16, 16, 12, 16, 16, 16, 16, 16, 16, 16, 16, 12, 16, 16, 12, 16, 16, 12, 16, 16, 16,16, 16, 16, 12, 16, 16, 12, 16, 16, 12, 16, 16, 16, 16, 16, 16, 16, 16, 12, 16, 16, 12, 16, 16, 12, 16, 16, 16, 16, 16, 16, 12, 16, 16, 12, 16, 16, 12, 16, 16, 16, 16, 16, 16, 16, 16, 12, 16, 16, 12, 16, 16, 12, 16, 16, 16
16,  5,  3, 11,  3,  3, 10, 16, 16,  9,  3,  3,  6, 16, 16,  5,  3,  3, 10, 16, 16,  9,  3,  3, 11,  3,  6, 16, 16,  5,  3, 11,  3,  3, 10, 16, 16,  9,  3,  3,  6, 16, 16,  5,  3,  3, 10, 16, 16,  9,  3,  3, 11,  3,  6, 16,16,  5,  3, 11,  3,  3, 10, 16, 16,  9,  3,  3,  6, 16, 16,  5,  3,  3, 10, 16, 16,  9,  3,  3, 11,  3,  6, 16, 16,  5,  3, 11,  3,  3, 10, 16, 16,  9,  3,  3,  6, 16, 16,  5,  3,  3, 10, 16, 16,  9,  3,  3, 11,  3,  6, 16
16, 12, 16, 16, 16, 16, 16, 16, 16, 16, 16, 16, 12, 16, 16, 12, 16, 16, 16, 16, 16, 16, 16, 16, 16, 16, 12, 16, 16, 12, 16, 16, 16, 16, 16, 16, 16, 16, 16, 16, 12, 16, 16, 12, 16, 16, 16, 16, 16, 16, 16, 16, 16, 16, 12, 16,16, 12, 16, 16, 16, 16, 16, 16, 16, 16, 16, 16, 12, 16, 16, 12, 16, 16, 16, 16, 16, 16, 16, 16, 16, 16, 12, 16, 16, 12, 16, 16, 16, 16, 16, 16, 16, 16, 16, 16, 12, 16, 16, 12, 16, 16, 16, 16, 16, 16, 16, 16, 16, 16, 12, 16
16, 12, 16, 16, 16, 16, 16, 16, 16, 16, 16, 16, 12, 16, 16, 12, 16, 16, 16, 16, 16, 16, 16, 16, 16, 16, 12, 16, 16, 12, 16, 16, 16, 16, 16, 16, 16, 16, 16, 16, 12, 16, 16, 12, 16, 16, 16, 16, 16, 16, 16, 16, 16, 16, 12, 16,16, 12, 16, 16, 16, 16, 16, 16, 16, 16, 16, 16, 12, 16, 16, 12, 16, 16, 16, 16, 16, 16, 16, 16, 16, 16, 12, 16, 16, 12, 16, 16, 16, 16, 16, 16, 16, 16, 16, 16, 12, 16, 16, 12, 16, 16, 16, 16, 16, 16, 16, 16, 16, 16, 12, 16
16,  9,  3,  3,  3,  3,  3,  3,  3,  3,  3,  3, 11,  3,  3, 11,  3,  3,  3,  3,  3,  3,  3,  3,  3,  3, 11,  3,  3, 11,  3,  3,  3,  3,  3,  3,  3,  3,  3,  3, 11,  3,  3, 11,  3,  3,  3,  3,  3,  3,  3,  3,  3,  3, 10, 16,16,  9,  3,  3,  3,  3,  3,  3,  3,  3,  3,  3, 11,  3,  3, 11,  3,  3,  3,  3,  3,  3,  3,  3,  3,  3, 11,  3,  3, 11,  3,  3,  3,  3,  3,  3,  3,  3,  3,  3, 11,  3,  3, 11,  3,  3,  3,  3,  3,  3,  3,  3,  3,  3, 10, 16
16, 16, 16, 16, 16, 16, 16, 16, 16, 16, 16, 16, 16, 16, 16, 16, 16, 16, 16, 16, 16, 16, 16, 16, 16, 16, 16, 16, 16, 16, 16, 16, 16, 16, 16, 16, 16, 16, 16, 16, 16, 16, 16, 16, 16, 16, 16, 16, 16, 16, 16, 16, 16, 16, 16, 16,16, 16, 16, 16, 16, 16, 16, 16, 16, 16, 16, 16, 16, 16, 16, 16, 16, 16, 16, 16, 16, 16, 16, 16, 16, 16, 16, 16, 16, 16, 16, 16, 16, 16, 16, 16, 16, 16, 16, 16, 16, 16, 16, 16, 16, 16, 16, 16, 16, 16, 16, 16, 16, 16, 16, 16