17, 17, 17, 17, 17, 17, 17, 17, 17, 17, 17, 17, 17, 17, 17, 17, 17, 17, 17, 17, 17, 17, 17, 17, 17, 17, 17, 17, 17, 17, 17, 17, 17, 17, 17, 17, 17, 17, 17, 17, 17, 17, 17, 17, 17, 17, 17, 17, 17, 17, 17, 17, 17, 17, 17, 17
17, 0, 0, 0, 0, 0, 0, 0, 0, 0, 0, 0, 0, 17, 17, 0, 0, 0, 0, 0, 0, 0, 0, 0, 0, 0, 0, 0, 0, 0, 0, 0, 0, 0, 0, 0, 0, 0, 0, 0, 0, 17, 17, 0, 0, 0, 0, 0, 0, 0, 0, 0, 0, 0, 0, 17
17, 0, 17, 17, 17, 17, 0, 17, 17, 17, 17, 17, 0, 17, 17, 0, 17, 17, 17, 17, 17, 0, 17, 17, 17, 17, 0, 17, 17, 0, 17, 17, 17, 17, 0, 17, 17, 17, 17, 17, 0, 17, 17, 0, 17, 17, 17, 17, 17, 0, 17, 17, 17, 17, 0, 17
17, 0, 17, 9, 16, 17, 0, 17, 16, 10, 9, 17, 0, 17, 17, 0, 17, 10, 9, 16, 17, 0, 17, 16, 10, 17, 0, 17, 17, 0, 17, 16, 9, 17, 0, 17, 9, 10, 16, 17, 0, 17, 17, 0, 17, 16, 9, 10, 17, 0, 17, 10, 16, 17, 0, 17
17, 0, 17, 17, 17, 17, 0, 17, 17, 17, 17, 17, 0, 17, 17, 0, 17, 17, 17, 17, 17, 0, 17, 17, 17, 17, 0, 17, 17, 0, 17, 17, 17, 17, 0, 17, 17, 17, 17, 17, 0, 17, 17, 0, 17, 17, 17, 17, 17, 0, 17, 17, 17, 17, 0, 17
17, 0, 0, 0, 0, 0, 0, 0, 0, 0, 0, 0, 0, 0, 0, 0, 0, 0, 0, 0, 0, 0, 0, 0, 0, 0, 0, 17, 17, 0, 0, 0, 0, 0, 0, 0, 0, 0, 0, 0, 0, 0, 0, 0, 0, 0, 0, 0, 0, 0, 0, 0, 0, 0, 0, 17
17, 0, 17, 17, 17, 17, 0, 17, 17, 0, 17, 17, 17, 17, 17, 17, 17, 17, 0, 17, 17, 0, 17, 17, 17, 17, 0, 17, 17, 0, 17, 17, 17, 17, 0, 17, 17, 0, 17, 17, 17, 17, 17, 17, 17, 17, 0, 17, 17, 0, 17, 17, 17, 17, 0, 17
17, 0, 17, 17, 17, 17, 0, 17, 17, 0, 17, 17, 17, 17, 17, 17, 17, 17, 0, 17, 17, 0, 17, 17, 17, 17, 0, 17, 17, 0, 17, 17, 17, 17, 0, 17, 17, 0, 17, 17, 17, 17, 17, 17, 17, 17, 0, 17, 17, 0, 17, 17, 17, 17, 0, 17
17, 0, 0, 0, 0, 0, 0, 17, 17, 0, 0, 0, 0, 17, 17, 0, 0, 0, 0, 17, 17, 0, 0, 0, 0, 0, 0, 0, 0, 0, 0, 0, 0, 0, 0, 17, 17, 0, 0, 0, 0, 17, 17, 0, 0, 0, 0, 17, 17, 0, 0, 0, 0, 0, 0, 17
17, 17, 17, 17, 17, 17, 0, 17, 17, 17, 17, 17, 0, 17, 17, 0, 17, 17, 17, 17, 17, 0, 17, 17, 17, 17, 17, 17, 17, 17, 17, 17, 17, 17, 0, 17, 17, 17, 17, 17, 0, 17, 17, 0, 17, 17, 17, 17, 17, 0, 17, 17, 17, 17, 17, 17
17, 10, 9, 16, 9, 17, 0, 17, 17, 17, 17, 17, 0, 17, 17, 0, 17, 17, 17, 17, 17, 0, 17, 17, 17, 17, 17, 17, 17, 17, 17, 17, 17, 17, 0, 17, 17, 17, 17, 17, 0, 17, 17, 0, 17, 17, 17, 17, 17, 0, 17, 9, 10, 9, 16, 17
17, 16, 10, 16, 16, 17, 0, 17, 17, 0, 0, 0, 0, 0, 0, 0, 0, 0, 0, 17, 17, 0, 0, 0, 0, 0, 0, 0, 0, 0, 0, 0, 0, 0, 0, 17, 17, 0, 0, 0, 0, 0, 0, 0, 0, 0, 0, 17, 17, 0, 17, 16, 16, 10, 9, 17
17, 9, 16, 10, 9, 17, 0, 17, 17, 0, 17, 17, 17, 17, 17, 17, 17, 17, 0, 17, 17, 0, 17, 17, 17, 17, 17, 17, 17, 17, 17, 17, 17, 17, 0, 17, 17, 0, 17, 17, 17, 17, 17, 17, 17, 17, 0, 17, 17, 0, 17, 10, 16, 16, 10, 17
17, 10, 16, 9, 10, 17, 0, 17, 17, 0, 17, 9, 16, 9, 10, 16, 10, 17, 0, 17, 17, 0, 17, 14, 5, 4, 4, 15, 4, 15, 13, 14, 5, 17, 0, 17, 17, 0, 17, 10, 16, 10, 16, 9, 9, 17, 0, 17, 17, 0, 17, 16, 10, 16, 9, 17
17, 16, 10, 16, 16, 17, 0, 0, 0, 0, 17, 16, 10, 9, 16, 10, 9, 17, 0, 0, 0, 0, 17, 13, 14, 15, 14, 14, 12, 14, 11, 4, 14, 17, 0, 0, 0, 0, 17, 16, 10, 9, 16, 10, 16, 17, 0, 0, 0, 0, 17, 9, 9, 10, 9, 17
17, 9, 9, 10, 9, 17, 0, 17, 17, 0, 17, 10, 16, 10, 9, 16, 16, 17, 0, 17, 17, 0, 17, 15, 13, 15, 12, 4, 13, 5, 15, 14, 13, 17, 0, 17, 17, 0, 17, 9, 16, 9, 10, 16, 10, 17, 0, 17, 17, 0, 17, 10, 16, 16, 10, 17
17, 10, 16, 16, 10, 17, 0, 17, 17, 0, 17, 17, 17, 17, 17, 17, 17, 17, 0, 17, 17, 0, 17, 17, 17, 17, 17, 17, 17, 17, 17, 17, 17, 17, 0, 17, 17, 0, 17, 17, 17, 17, 17, 17, 17, 17, 0, 17, 17, 0, 17, 16, 10, 16, 16, 17
17, 16, 10, 16, 9, 17, 0, 17, 17, 0, 0, 0, 0, 0, 0, 0, 0, 0, 0, 17, 17, 0, 0, 0, 0, 0, 0, 0, 0, 0, 0, 0, 0, 0, 0, 17, 17, 0, 0, 0, 0, 0, 0, 0, 0, 0, 0, 17, 17, 0, 17, 16, 16, 10, 16, 17
17, 9, 16, 10, 9, 17, 0, 17, 17, 0, 17, 17, 17, 17, 17, 17, 17, 17, 0, 17, 17, 0, 17, 17, 17, 17, 17, 17, 17, 17, 17, 17, 17, 17, 0, 17, 17, 0, 17, 17, 17, 17, 17, 17, 17, 17, 0, 17, 17, 0, 17, 9, 9, 9, 10, 17
17, 17, 17, 17, 17, 17, 0, 17, 17, 0, 17, 17, 17, 17, 17, 17, 17, 17, 0, 17, 17, 0, 17, 17, 17, 17, 17, 17, 17, 17, 17, 17, 17, 17, 0, 17, 17, 0, 17, 17, 17, 17, 17, 17, 17, 17, 0, 17, 17, 0, 17, 17, 17, 17, 17, 17
17, 0, 0, 0, 0, 0, 0, 0, 0, 0, 0, 0, 0, 17, 17, 0, 0, 0, 0, 0, 0, 0, 0, 0, 0, 0, 0, 0, 0, 0, 0, 0, 0, 0, 0, 0, 0, 0, 0, 0, 0, 17, 17, 0, 0, 0, 0, 0, 0, 0, 0, 0, 0, 0, 0, 17
17, 0, 17, 17, 17, 17, 0, 17, 17, 17, 17, 17, 0, 17, 17, 0, 17, 17, 17, 17, 17, 0, 17, 17, 17, 17, 0, 17, 17, 0, 17, 17, 17, 17, 0, 17, 17, 17, 17, 17, 0, 17, 17, 0, 17, 17, 17, 17, 17, 0, 17, 17, 17, 17, 0, 17
17, 0, 17, 17, 17, 17, 0, 17, 17, 17, 17, 17, 0, 17, 17, 0, 17, 17, 17, 17, 17, 0, 17, 17, 17, 17, 0, 17, 17, 0, 17, 17, 17, 17, 0, 17, 17, 17, 17, 17, 0, 17, 17, 0, 17, 17, 17, 17, 17, 0, 17, 17, 17, 17, 0, 17
17, 0, 0, 0, 17, 17, 0, 0, 0, 0, 0, 0, 0, 0, 0, 0, 0, 0, 0, 0, 0, 0, 17, 17, 0, 0, 0, 17, 17, 0, 0, 0, 17, 17, 0, 0, 0, 0, 0, 0, 0, 0, 0, 0, 0, 0, 0, 0, 0, 0, 17, 17, 0, 0, 0, 17
17, 17, 17, 0, 17, 17, 0, 17, 17, 0, 17, 17, 17, 17, 17, 17, 17, 17, 0, 17, 17, 0, 17, 17, 0, 17, 17, 17, 17, 17, 17, 0, 17, 17, 0, 17, 17, 0, 17, 17, 17, 17, 17, 17, 17, 17, 0, 17, 17, 0, 17, 17, 0, 17, 17, 17
17, 17, 17, 0, 17, 17, 0, 17, 17, 0, 17, 17, 17, 17, 17, 17, 17, 17, 0, 17, 17, 0, 17, 17, 0, 17, 17, 17, 17, 17, 17, 0, 17, 17, 0, 17, 17, 0, 17, 17, 17, 17, 17, 17, 17, 17, 0, 17, 17, 0, 17, 17, 0, 17, 17, 17
17, 0, 0, 0, 0, 0, 0, 17, 17, 0, 0, 0, 0, 17, 17, 0, 0, 0, 0, 17, 17, 0, 0, 0, 0, 0, 0, 17, 17, 0, 0, 0, 0, 0, 0, 17, 17, 0, 0, 0, 0, 17, 17, 0, 0, 0, 0, 17, 17, 0, 0, 0, 0, 0, 0, 17
17, 0, 17, 17, 17, 17, 17, 17, 17, 17, 17, 17, 0, 17, 17, 0, 17, 17, 17, 17, 17, 17, 17, 17, 17, 17, 0, 17, 17, 0, 17, 17, 17, 17, 17, 17, 17, 17, 17, 17, 0, 17, 17, 0, 17, 17, 17, 17, 17, 17, 17, 17, 17, 17, 0, 17
17, 0, 17, 17, 17, 17, 17, 17, 17, 17, 17, 17, 0, 17, 17, 0, 17, 17, 17, 17, 17, 17, 17, 17, 17, 17, 0, 17, 17, 0, 17, 17, 17, 17, 17, 17, 17, 17, 17, 17, 0, 17, 17, 0, 17, 17, 17, 17, 17, 17, 17, 17, 17, 17, 0, 17
17, 0, 0, 0, 0, 0, 0, 0, 0, 0, 0, 0, 0, 0, 0, 0, 0, 0, 0, 0, 0, 0, 0, 0, 0, 0, 0, 0, 0, 0, 0, 0, 0, 0, 0, 0, 0, 0, 0, 0, 0, 0, 0, 0, 0, 0, 0, 0, 0, 0, 0, 0, 0, 0, 0, 17
17, 17, 17, 17, 17, 17, 17, 17, 17, 17, 17, 17, 17, 17, 17, 17, 17, 17, 17, 17, 17, 17, 17, 17, 17, 17, 17, 17, 17, 17, 17, 17, 17, 17, 17, 17, 17, 17, 17, 17, 17, 17, 17, 17, 17, 17, 17, 17, 17, 17, 17, 17, 17, 17, 17, 17
